NO ./parsinggggg/textures/images/testt.xpm
EA ./parsinggggg/textures/images/EA.xpm
SO ./parsinggggg/textures/images/SO.xpm
WE ./parsinggggg/textures/images/WE.xpm
C 74,183,216
F 100, 100, 00



                 11111111111111111111
                 100000000000000000001
                 100000000000000000001
                 100000000000000000001
                 1000000000N0000000001
                 100000000000000000001
                  1111111111111111111